abrupt	陡峭的; 突然的，意外的; 无理的，唐突的; 不连贯的	英 [əˈbrʌpt]　美 [əˈbrʌpt]　
absurd	荒谬的; 荒唐的; 无理性的，杂乱无章的; 荒诞主义的，荒诞的	英 [əbˈsɜ:d]　美 [əbˈsɜ:rd]　
abundance	丰度; 丰富，充裕; 大量，极多; 盈余	英 [əˈbʌndəns]　美 [əˈbʌndəns]　
accessory	附件; 从犯; （衣服的）配饰; 妇女饰品	英 [əkˈsesəri]　美 [ækˈsɛsəri]　
accommodate	容纳; 使适应; 向…提供住处; 帮忙	英 [əˈkɒmədeɪt]　美 [əˈkɑ:mədeɪt]　
acquaint	使熟悉; 使认识; 把某事通知某人，告知	英 [əˈkweɪnt]　美 [əˈkwent]　
adjoin	邻近，毗连; 接，贴连; 附加，使结合	英 [əˈdʒɔɪn]　美 [əˈdʒɔɪn]　
adolescent	少年，少女	英 [ˌædəˈlesnt]　美 [ˌædə'lesnt]　
adore	崇拜; 爱慕; 非常喜欢; 敬佩	英 [əˈdɔ:(r)]　美 [əˈdɔr, əˈdor]　
affiliate	使隶属于，接纳…为成员; 使紧密联系	英 [əˈfɪlieɪt]　美 [əˈfɪliˌeɪt]　
air-conditioning	空调设备，空调系统	英 ['eərkənd'ɪʃnɪŋ]　美 ['eərkənd'ɪʃnɪŋ]　
allege	断言，宣称，辩解; 提出…作为理由	英 [əˈledʒ]　美 [əˈlɛdʒ]　
alloy	合金; （合金中的）劣等金属; 搀杂品; 成色	英 [ˈælɔɪ]　美 [ˈælˌɔɪ]　
amend	修订; 改良，修改	英 [əˈmend]　美 [əˈmɛnd]　
ammunition	子弹; 弹药，军火; 军需品; 战斗手段	英 [ˌæmjuˈnɪʃn]　美 [ˌæmjəˈnɪʃən]　
ample	足够的; 充足的，丰富的; 宽敞的，广大的; 富裕的	英 [ˈæmpl]　美 [ˈæmpəl]　
angel	安琪儿; 天使，天使般的人; 守护神; 善良可爱的人	英 [ˈeɪndʒl]　美 [ˈendʒəl]　
apparatus	仪器，器械; 机器; 机构，机关; 器官	英 [ˌæpəˈreɪtəs]　美 [ˌæpəˈrætəs]　
arc	综合症状; 弧（度）; 天穹; 电弧，弧光。	英 [ɑ:k]　美 [ɑ:rk]　
arena	竞技场; 表演场地，舞台; 活动或斗争的场所或场面; 古罗马圆形剧场中央的竞技场	英 [əˈri:nə]　美 [əˈrinə]　
armour	装甲; 装甲部队; 甲胄，盔甲; 装甲车辆	英 ['ɑ:mə(r)]　美 [ˈɑrmɚ]　
arrogant	骄；傲慢的，自大的；带有傲慢，出自傲慢；骄慢；	英 [ˈærəgənt]　美 [ˈærəɡənt]　
assert	声称，断言; 维护，坚持; 坚持自己的主张; 生效	英 [əˈsɜ:t]　美 [əˈsɜ:rt]　
assimilate	同化; 吸收， 消化	英 [əˈsɪməleɪt]　美 [əˈsɪməˌlet]　
authorise	授权，批准，委托；	英 ['ɒθəraɪz]　美 ['ɒθəraɪz]　
autonomous	自治的; 有自主权的; [生，植]自发的	英 [ɔ:ˈtɒnəməs]　美 [ɔ:ˈtɑ:nəməs]　
avail	效用，利益	英 [əˈveɪl]　美 [əˈvel]　
bull	公牛; 股市看涨的人; 力大如牛的人; 大型雄性动物	英 [bʊl]　美 [bʊl]　
bulletin	公告，公报; 新闻快报; 小报; 期刊	英 [ˈbʊlətɪn]　美 [ˈbʊlɪtn, -tɪn]　
bypass	旁道，支路; 迂回管道; [电]分路迂徊; [医]导管	英 [ˈbaɪpɑ:s]　美 [ˈbaɪˌpæs]　
bald	秃头的; 光秃的; 单调的，枯燥的; 赤裸裸的，毫无掩饰的	英 [bɔ:ld]　美 [bɔld]　
ballet	芭蕾舞; 芭蕾舞团; 芭蕾舞剧; 芭蕾舞音乐	英 [ˈbæleɪ]　美 [bæˈle,ˈbælˌe]　
banquet	筵席; 宴会，盛宴; 宴请，款待	英 [ˈbæŋkwɪt]　美 [ˈbæŋkwɪt]　
barren	贫瘠的; 不结果实的; 不孕的; 无价值的	英 [ˈbærən]　美 [ˈbærən]　
batch	一批; 一炉; （食物、药物等的）一批生产的量; 成批作业	英 [bætʃ]　美 [bætʃ]　
beforehand	提前; 事先，预先	英 [bɪˈfɔ:hænd]　美 [bɪˈfɔ:rhænd]　
bewilder	使迷惑; 使为难; 使手足无措; 使变糊涂	英 [bɪˈwɪldə(r)]　美 [bɪˈwɪldɚ]　
bias	偏见; 倾向; 偏爱，爱好; 斜纹	英 [ˈbaɪəs]　美 [ˈbaɪəs]　
bibliography	书目提要，书目; 书志学，书志; 文献，文献学	英 [ˌbɪbliˈɒgrəfi]　美 [ˌbɪbliˈɑ:grəfi]　
biography	传记; 档案; 传记体文学; 个人简介	英 [baɪˈɒgrəfi]　美 [baɪˈɑ:grəfi]　
blaze	火焰; 光辉; 爆发; 光彩	英 [bleɪz]　美 [blez]　
blossom	花，群花; 开花时期，（发育的）初期; 兴旺时期	英 [ˈblɒsəm]　美 [ˈblɑ:səm]　
blunder	（因无知、粗心等造成）的错误; 大错，失策，疏忽	英 [ˈblʌndə(r)]　美 [ˈblʌndɚ]　
blur	污迹，污斑; 模糊不清的事物; 暧昧不明	英 [blɜ:(r)]　美 [blɚ]　
bonus	奖金，额外津贴; 红利，额外股息; 退职金; 额外令人高兴的事情	英 [ˈbəʊnəs]　美 [ˈboʊnəs]　
bowel	肠; 内部; 同情心，怜悯心	英 [ˈbaʊəl]　美 [ˈbaʊəl, baʊl]　
brew	酿造; 泡，煮; 策划，酿成	英 [bru:]　美 [bru]　
bribe	贿赂，行贿	英 [braɪb]　美 [braɪb]　
brink	边缘; （悬崖峭壁的）边沿; （危险的）边沿; 初始状态	英 [brɪŋk]　美 [brɪŋk]　
bronze	青铜; 铜牌; 青铜色; 青铜艺术品	英 [brɒnz]　美 [brɑ:nz]　
bruise	使挫伤	英 [bru:z]　美 [bruz]　
brutal	残忍的; 野蛮的; 无情的; 不讲理的	英 [ˈbru:tl]　美 [ˈbrutl]　
cafeteria	自助餐厅	英 [ˌkæfəˈtɪəriə]　美 [ˌkæfəˈtɪriə]　
calcium	钙	英 [ˈkælsiəm]　美 [ˈkælsiəm]　
cane	手杖; （植物的）茎; 棍棒，棒; 藤条，藤料	英 [keɪn]　美 [ken]　
cannon	大炮; 加农炮; 机关炮; 榴弹炮	英 [ˈkænən]　美 [ˈkænən]　
canvas	帆布; 油画（布）	英 [ˈkænvəs]　美 [ˈkænvəs]　
cater	提供饮食及服务	英 [ˈkeɪtə(r)]　美 [ˈketɚ]　
caption	字幕; 标题，说明文字，字幕; 第三档	英 [ˈkæpʃn]　美 [ˈkæpʃən]　
casualty	伤亡（人数）; 事故，横祸; 受害者，死伤者; 损坏	英 [ˈkæʒuəlti]　美 [ˈkæʒuəlti]　
catastrophe	大灾难; 惨败; 悲剧的结局; 地表突然而猛烈的变动，灾变	英 [kəˈtæstrəfi]　美 [kəˈtæstrəfi]　
ceramic	陶器的，与陶器有关的; 陶瓷的，陶制的; 制陶的	英 [səˈræmɪk]　美 [səˈræmɪk]　
cereal	谷物; 粮食; 谷类植物; 荞麦食品	英 [ˈsɪəriəl]　美 [ˈsɪriəl]　
certify	（尤指书面）证明; 发证书给…; 证明（某人）患有精神病; 颁发（或授予）专业合格证书	英 [ˈsɜ:tɪfaɪ]　美 [ˈsɜ:rtɪfaɪ]　
chant	吟颂，咏唱; 反复有节奏地喊叫（或唱等）	英 [tʃɑ:nt]　美 [tʃænt]　
cherish	珍爱; 爱护; 怀有; 抚育	英 [ˈtʃerɪʃ]　美 [ˈtʃɛrɪʃ]　
chronic	慢性的; 长期的; 习惯性的; 痼	英 [ˈkrɒnɪk]　美 [ˈkrɑ:nɪk]　
circulation	血液循环; 流通，传播; 发行量; （某段时间的）社交活动	英 [ˌsɜ:kjəˈleɪʃn]　美 [ˌsɜ:rkjəˈleɪʃn]　
circus	马戏，马戏团; 马戏表演（常在大帐篷里进行）; 环形广场，（用于某些地名）圆形广场; 乱哄哄的热闹场面	英 [ˈsɜ:kəs]　美 [ˈsɜ:rkəs]　
clarity	清晰度; 明确; 透明; 清楚，明晰	英 [ˈklærəti]　美 [ˈklærɪti]　
cluster	群; 丛; 簇，串; [语言]辅音群	英 [ˈklʌstə(r)]　美 [ˈklʌstɚ]　
cocaine	古柯碱; 可卡因	英 [kəʊˈkeɪn]　美 [koʊˈkeɪn]　
cocktail	鸡尾酒; 混合物; 餐前开胃菜	英 [ˈkɒkteɪl]　美 [ˈkɑ:kteɪl]　
coincide	相符; 与…一致; 想法、意见等相同; 极为类似	英 [ˌkəʊɪnˈsaɪd]　美 [ˌkoʊɪnˈsaɪd]　
coincidence	巧合; 一致; 同时存在; 并存	英 [kəʊˈɪnsɪdəns]　美 [koʊˈɪnsɪdəns]　
collide	碰撞; 相撞; 冲突; 抵触	英 [kəˈlaɪd]　美 [kəˈlaɪd]　
colonial	殖民地的; 殖民地化的; [生]群体的，集群的; 英领殖民地时期的	英 [kəˈləʊniəl]　美 [kəˈloʊniəl]　
comet	[天]彗星; 孛	英 [ˈkɒmɪt]　美 [ˈkɑ:mət]　
commence	开始; 着手; 获得学位	英 [kəˈmens]　美 [kəˈmɛns]　
commend	推荐; 表扬; 托付; 受到赞同	英 [kəˈmend]　美 [kəˈmɛnd]　
commentary	解说词; 评论，评注; 注释，注解; 个人生平传记	英 [ˈkɒməntri]　美 [ˈkɑ:mənteri]　
commodity	商品; 日用品; 有价值的物品; 有利，有益	英 [kəˈmɒdəti]　美 [kəˈmɑ:dəti]　
compact	压紧，（使）坚实; 把…弄紧密，把…弄结实; 使（文体）简洁，简化; 变紧密，变结实	英 [kəmˈpækt]　美 [ˈkɑ:mˈpækt]　
compartment	隔间（尤指火车车厢中的）; 区划	英 [kəmˈpɑ:tmənt]　美 [kəmˈpɑ:rtmənt]　
compatible	兼容的，相容的; 和谐的，协调的; [生物学]亲和的; 可以并存的，能共处的	英 [kəmˈpætəbl]　美 [kəmˈpætəbəl]　
competence	能力; 技能; 相当的资产	英 [ˈkɒmpɪtəns]　美 [ˈkɑ:mpɪtəns]　
compile	编译; 编制; 汇编; 编辑	英 [kəmˈpaɪl]　美 [kəmˈpaɪl]　
conscientious	认真负责的; 本着良心的; 谨慎的; 正大光明	英 [ˌkɒnʃiˈenʃəs]　美 [ˌkɑ:nʃiˈenʃəs]　
composite	混合成的，综合成的; [建]综合式的; [数]可分解的; [植]菊科的	英 [ˈkɒmpəzɪt]　美 [kəmˈpɑ:zət]　
comply	遵从; 依从，顺从; 应允，同意	英 [kəmˈplaɪ]　美 [kəmˈplaɪ]　
compliment	恭维; 敬意; 道贺，贺词; 致意	英 [ˈkɒmplɪmənt]　美 [ˈkɑ:mplɪmənt]　
compute	计算，估算; 推断; 用计算机计算	英 [kəmˈpju:t]　美 [kəmˈpjut]　
conception	概念; 受精，怀孕; 胚胎; 设想，构想	英 [kənˈsepʃn]　美 [kənˈsɛpʃən]　
confer	授予，颁与; 比较，对照	英 [kənˈfɜ:(r)]　美 [kənˈfɚ]　
confidential	机密的; 秘密的; 表示信任的; 亲密的	英 [ˌkɒnfɪˈdenʃl]　美 [ˌkɑ:nfɪˈdenʃl]　
configuration	配置; 布局，构造; [化]（分子中原子的）组态，排列; [物]位形，组态	英 [kənˌfɪgəˈreɪʃn]　美 [kənˌfɪgjəˈreɪʃn]　
consecutive	连续的，连贯的; [语]表示结果的	英 [kənˈsekjətɪv]　美 [kənˈsɛkjətɪv]　
conserve	保护，保藏，保存; [化，物]使守恒; 将…做成蜜饯	英 [kənˈsɜ:v]　美 [kənˈsɜ:rv]　
console	安慰，慰问	英 [kən'səʊl]　美 [kənˈsoʊl]　
conspicuous	明显的; 显而易见的; 惹人注意的; 显目	英 [kənˈspɪkjuəs]　美 [kənˈspɪkjuəs]　
constituent	选民; 成分，构成部分; 委托人	英 [kənˈstɪtjuənt]　美 [kənˈstɪtʃuənt]　
constrain	约束; 限制; 强迫; 强使	英 [kənˈstreɪn]　美 [kənˈstren]　
contemplate	注视，凝视; 盘算，计议; 周密考虑	英 [ˈkɒntəmpleɪt]　美 [ˈkɑ:ntəmpleɪt]　
contempt	轻蔑; 轻视; （对规则、危险等的）藐视; 不顾	英 [kənˈtempt]　美 [kənˈtɛmpt]　
contend	争夺; 竞争; 奋斗; 争斗	英 [kənˈtend]　美 [kənˈtɛnd]　
contention	争夺; 论点; 竞争，争论	英 [kənˈtenʃn]　美 [kənˈtɛnʃən]　
continuity	连续性，继续; 分镜头电影剧本; 串联，衔接; [影视]剪辑	英 [ˌkɒntɪˈnju:əti]　美 [ˌkɑ:ntəˈnu:əti]　
contradict	反驳，驳斥; 否认; 与…矛盾，与…抵触	英 [ˌkɒntrəˈdɪkt]　美 [ˌkɑ:ntrəˈdɪkt]　
contrive	策划; 设计，发明; 创造; 设法做到	英 [kənˈtraɪv]　美 [kənˈtraɪv]　
convene	召集; 聚集; 传唤	英 [kənˈvi:n]　美 [kənˈvin]　
conversion	变换，转变; 改装物; 财产转换，兑换; [逻] 换位（法）	英 [kənˈvɜ:ʃn]　美 [kənˈvɜ:rʒn]　
corporate	法人的，团体的，社团的; 公司的，总体国家的; 〈古〉团结的; 共同的，全体的	英 [ˈkɔ:pərət]　美 [ˈkɔ:rpərət]　
corps	兵团; 特种部队; 一群人，一组人	英 [kɔ:z]　美 [kɔ:rz]　
corrode	使腐蚀，侵蚀	英 [kəˈrəʊd]　美 [kəˈroʊd]　
corrupt	堕落的，道德败坏的; 贪污的，腐败的; 腐烂的; （文献等）错误百出的	英 [kəˈrʌpt]　美 [kəˈrʌpt]　
couch	长沙发椅，睡椅; （病人受检查时躺的）长榻; 麦芽床; 涂底，涂层	英 [kaʊtʃ]　美 [kaʊtʃ]　
counterpart	副本; 配对物; 相对物; 极相似的人或物	英 [ˈkaʊntəpɑ:t]　美 [ˈkaʊntərpɑ:rt]　
coward	胆小鬼，懦夫	英 [ˈkaʊəd]　美 [ˈkaʊərd]　
cozy	舒适的，安逸的，惬意的	英 ['kəʊzɪ]　美 [ˈkozi]　
cradle	摇篮; 发源地，发祥地; 吊架，支架; 婴儿时期	英 [ˈkreɪdl]　美 [ˈkredl]　
credible	可信的，可靠的; （因看似可能成功而）可接受的	英 [ˈkredəbl]　美 [ˈkrɛdəbəl]　
crisp	脆的; 干冷的; 易碎的; 新鲜的，爽快的	英 [krɪsp]　美 [krɪsp]　
crumble	弄碎; 把…弄成碎屑	英 [ˈkrʌmbl]　美 [ˈkrʌmbəl]　
culminate	达到极点	英 [ˈkʌlmɪneɪt]　美 [ˈkʌlməˌnet]　
cumulative	累积的; 渐增的; 追加的; （判刑等）加重的	英 [ˈkju:mjələtɪv]　美 [ˈkju:mjəleɪtɪv]　
customary	习惯的; 通常的; 照惯例的	英 [ˈkʌstəməri]　美 [ˈkʌstəmeri]　
cute	漂亮的; 娇小可爱的; 机灵的，精明的; 矫揉造作的	英 [kju:t]　美 [kjut]　
database	数据库; 资料库; 信息库	英 [ˈdeɪtəbeɪs]　美 [ˈdetəˌbes, ˈdætə-]　
deadly	极端的，非常的; 致命的，致死的; 非常有效的; 如死一般的	英 [ˈdedli]　美 [ˈdɛdli]　
dean	教务长; （大学的）学院院长，系主任; [宗]主任牧师; （大学，尤指牛津、剑桥大学的）学监	英 [di:n]　美 [din]　
decimal	十进位的，小数的	英 [ˈdesɪml]　美 [ˈdɛsəməl]　
decisive	决定性的; 坚定的; 果断的，决断的	英 [dɪˈsaɪsɪv]　美 [dɪˈsaɪsɪv]　
deduce	演绎; 推论，推断; 追溯根源	英 [dɪˈdju:s]　美 [dɪˈdu:s]　
deem	认为，视为; 主张，断定	英 [di:m]　美 [dim]　
default	未履行任务或责任; 受传唤时未出庭; 由于不到庭而败诉; 弃权	英 [dɪˈfɔ:lt]　美 [dɪˈfɔlt]　
defiance	蔑视; 反抗; 挑战	英 [dɪˈfaɪəns]　美 [dɪˈfaɪəns]　
defy	蔑视; 公然反抗; 不服从; 向…挑战	英 [dɪˈfaɪ]　美 [dɪˈfaɪ]　
degenerate	退化的; 堕落的; 变质的; 变性的	英 [dɪˈdʒenəreɪt]　美 [dɪ'dʒenəreɪt]　
degrade	降低，贬低; 使降级; 降低…身分; 使丢脸	英 [dɪˈgreɪd]　美 [dɪˈɡred]　
denial	克制; 否认，否定; 拒绝，拒绝接受	英 [dɪˈnaɪəl]　美 [dɪˈnaɪəl]　
deport	行为，举动; 把…驱逐出境	英 [dɪˈpɔ:t]　美 [dɪˈpɔ:rt]　
deprive	剥夺，夺去，使丧失	英 [dɪˈpraɪv]　美 [dɪˈpraɪv]　
despatch	派遣	英 [dɪ'spætʃ]　美 [dɪˈspætʃ]　
destined	命中注定的，预定的; 去往…的	英 [ˈdestɪnd]　[ˈdestind]　
detain	耽搁; 留住，阻住; 拘留，扣留	英 [dɪˈteɪn]　美 [dɪˈten]　
deteriorate	使恶化	英 [dɪˈtɪəriəreɪt]　美 [dɪˈtɪriəreɪt]　
differentiate	区分，区别，辨别	英 [ˌdɪfəˈrenʃieɪt]　美 [ˌdɪfəˈrɛnʃiˌet]　
diffuse	四散的; 散开的; 冗长的; 累赘的	英 [dɪˈfju:s]　美 [dɪˈfjuz]　
dignity	尊严; 自尊; 高尚; 自豪	英 [ˈdɪgnəti]　美 [ˈdɪgnəti]　
dilute	稀释，冲淡	英 [daɪˈlu:t]　美 [daɪˈlut, dɪ-]　
diploma	毕业文凭; 学位证书; 公文; 奖状	英 [dɪˈpləʊmə]　美 [dɪˈploʊmə]　
disable	使无能力; 使残废，使伤残; 使无资格; 使不中用	英 [dɪsˈeɪbl]　美 [dɪsˈebəl]　
discern	看出; 理解，了解; 识别，辨别	英 [dɪˈsɜ:n]　美 [dɪˈsɜ:rn]　
disclose	公开; 揭露; 使显露; 使暴露	英 [dɪsˈkləʊz]　美 [dɪsˈkloʊz]　
discreet	持重; 小心的; 谨慎的，慎重的; 考虑周到的	英 [dɪˈskri:t]　美 [dɪˈskrit]　
discrepancy	矛盾; 不符合（之处）	英 [dɪsˈkrepənsi]　美 [dɪˈskrɛpənsi]　
discrete	分离的，不相关联的; 分立式; 非连续	英 [dɪˈskri:t]　美 [dɪˈskrit]　
dismay	使惊愕，使焦虑，使气馁	英 [dɪsˈmeɪ]　美 [dɪsˈme]　
dispatch	派遣，调度; （迅速地）发出; 迅速处理，迅速了结; 处决（罪犯等）	英 [dɪˈspætʃ]　美 [dɪˈspætʃ]　
disperse	（使）分散，（使）散开; 散播，传布（如知识）; 使（光）色散; 使粒子分散	英 [dɪˈspɜ:s]　美 [dɪˈspɜ:rs]　
displace	移动，移走; 替换，取代; 排水; 撤职	英 [dɪsˈpleɪs]　美 [dɪsˈples]　
disposition	性情，性格; 意向，倾向; 安排，配置; 部署，战略（战术）计划	英 [ˌdɪspəˈzɪʃn]　美 [ˌdɪspəˈzɪʃən]　
disregard	不顾; 不理会; 漠视，忽视; 蔑视，轻视	英 [ˌdɪsrɪˈgɑ:d]　美 [ˌdɪsrɪˈgɑ:rd]　
distil	蒸馏; 从…提取精华; 使渗出; 用蒸馏法制造	英 [dɪˈstɪl]　美 [dɪˈstɪl]　
distill	蒸馏，提取，滴下	英 [dɪs'tɪl]　美 [dɪˈstɪl]　
disturbance	困扰; 打扰; 骚乱，变乱; 烦闷	英 [dɪˈstɜ:bəns]　美 [dɪˈstɜ:rbəns]　
divert	使转移; 娱乐; 转移注意力	英 [daɪˈvɜ:t]　美 [daɪˈvɜ:rt]　
dividend	红利，股息，利息，（破产时清算的）分配金; [数]被除数 opp. divisor; （足球彩票的）彩金	英 [ˈdɪvɪdend]　美 [ˈdɪvɪˌdɛnd]　
divine	神圣的; 神的， 天赐的; 极好的	英 [dɪˈvaɪn]　美 [dɪˈvaɪn]　
dock	码头; 被告席; 草本植物; 尾巴的骨肉部份	英 [dɒk]　美 [dɑ:k]　
dodge	闪躲; 回避	英 [dɒdʒ]　美 [dɑ:dʒ]　
dolphin	海豚; （码头的）系船柱	英 [ˈdɒlfɪn]　美 [ˈdɑ:lfɪn]　
dome	圆屋顶; 像圆屋顶一样的东西; 圆顶体育场	英 [dəʊm]　美 [doʊm]　
donate	（尤指向慈善机构）捐赠; 献（血）; 捐（血）; 捐献（器官）	英 [dəʊˈneɪt]　美 [ˈdoʊneɪt]　
doom	厄运; 命运; 死亡; （尤指不利的、有罪的）判决，宣判	英 [du:m]　美 [dum]　
drainage	排水系统; 排水，放水; 排走物，废水; 排水区域	英 [ˈdreɪnɪdʒ]　美 [ˈdrenɪdʒ]　
drastic	激烈的; 极端的; 猛烈的; （法律等）严厉的	英 [ˈdræstɪk]　美 [ˈdræstɪk]　
drawback	退税; 缺点，劣势	英 [ˈdrɔ:bæk]　美 [ˈdrɔˌbæk]　
dread	害怕，担心; （古语）敬畏	英 [dred]　美 [drɛd]　
dubious	可疑的; 半信半疑的，犹豫不决的; 暧昧的，含糊的; 不可靠的	英 [ˈdju:biəs]　美 [ˈdu:biəs]　
exotic	异国的; 外来的; 异乎寻常的，奇异的; 吸引人的	英 [ɪgˈzɒtɪk]　美 [ɪgˈzɑ:tɪk]　
expel	驱逐; 赶走; 把…除名; 排出（气体等）	英 [ɪkˈspel]　美 [ɪkˈspɛl]　
expend	花费; 耗尽; 用光	英 [ɪkˈspend]　美 [ɪkˈspɛnd]　
exposition	博览会; 阐述; 展览会	英 [ˌekspəˈzɪʃn]　美 [ˌɛkspəˈzɪʃən]　
exquisite	精致的; 细腻的; 优美的; 剧烈的	英 [ɪkˈskwɪzɪt]　美 [ˈɛkskwɪzɪt, ɪkˈskwɪzɪt]　
extinct	灭绝的; 绝种的; 消逝的; 破灭的	英 [ɪkˈstɪŋkt]　美 [ɪkˈstɪŋkt]　
empirical	经验主义的; 凭经验的; 以观察或实验为依据的	英 [ɪmˈpɪrɪkl]　美 [ɛmˈpɪrɪkəl]　
embody	表现，象征; 包含，收录; 使具体化; [军]组编	英 [ɪmˈbɒdi]　美 [ɪmˈbɑ:di]　
embed	把…嵌入; 栽种; 深留（记忆中）	英 [ɪm'bed]　美 [ɛmˈbɛd]　
eclipse	[天]（日、月）食; 消失，黯然失色; 漆黑	英 [ɪˈklɪps]　美 [ɪˈklɪps]　
ecology	生态学; 社会生态学; 个体生态学	英 [iˈkɒlədʒi]　美 [iˈkɑ:lədʒi]　
edible	可以吃的，可食用的	英 [ˈedəbl]　美 [ˈɛdəbəl]　
ego	自我; 自负; 自尊心; 自我意识	英 [ˈi:gəʊ]　美 [ˈi:goʊ]　
elapse	消逝; 时间过去	英 [ɪˈlæps]　美 [ɪˈlæps]　
electrician	电工，电气技师	英 [ɪˌlekˈtrɪʃn]　美 [ɪlɛkˈtrɪʃən, ˌilɛk-]　
elite	精华; 精锐，精英; 上层集团; （统称）掌权人物	英 [eɪˈli:t]　美 [ɪˈlit, eˈlit]　
embark	上飞机，上船; 着手，从事	英 [ɪmˈbɑ:k]　美 [ɪmˈbɑ:rk]　
enclosure	附件; 圈占; 围绕; 圈占地	英 [ɪnˈkləʊʒə(r)]　美 [ɪnˈkloʊʒə(r)]　
enlighten	启发，启蒙; 开导，教导; 〈古〉照耀	英 [ɪnˈlaɪtn]　美 [ɛnˈlaɪtn]　
engagement	约会; 订婚，婚约; 约定，契约; 雇用	英 [ɪnˈgeɪdʒmənt]　美 [ɛnˈɡedʒmənt]　
entrepreneur	企业家; 主办人; 承包人	英 [ˌɒntrəprəˈnɜ:(r)]　美 [ˌɑ:ntrəprəˈnɜ:(r)]　
entity	实体; 实际存在物; 本质	英 [ˈentəti]　美 [ˈɛntɪti]　
enthusiastic	热情的; 热心的; 热烈的; 狂热的	英 [ɪnˌθju:ziˈæstɪk]　美 [ɪnˌθu:ziˈæstɪk]　
entail	需要; 牵涉; 使必要; 限定继承	英 [ɪnˈteɪl]　美 [ɛnˈtel, ɪn-]　
equator	赤道; （平分球形物体的面的）圆; （任何）大圆	英 [ɪˈkweɪtə(r)]　美 [ɪˈkwetɚ]　
epidemic	流行病; 迅速的传播、生长或发展; 风尚等的流行	英 [ˌepɪˈdemɪk]　美 [ˌɛpɪˈdɛmɪk]　
esthetic	审美的;  美学的; 有关美的; 悦目的	英 [es'θetɪk]　美 [ɛsˈθɛtɪk]　
essence	香精; 本质，实质; 精华，精髓	英 [ˈesns]　美 [ˈɛsəns]　
escort	护送者; 护航舰; 陪同某人参加社交活动的人（尤指男人）; 受雇陪同某人外出社交的人（尤指女人）	英 [ˈeskɔ:t]　美 [ˈeskɔ:rt]　
evacuate	撤离，疏散; 排泄; 腾出（房子等）; 除清，抽空	英 [ɪˈvækjueɪt]　美 [ɪˈvækjuˌet]　
evoke	唤起; 产生，引起	英 [ɪˈvəʊk]　美 [ɪˈvoʊk]　
esteem	尊敬，敬重; 认为，以为; 考虑; 估价	英 [ɪˈsti:m]　美 [ɪˈstim]　
ethnic	种族的，部落的; 某文化群体的	英 [ˈeθnɪk]　美 [ˈɛθnɪk]　
facet	小平面; 侧面，方面; （昆虫的）小眼面; [建]柱槽筋	英 [ˈfæsɪt]　美 [ˈfæsɪt]　
feeble	虚弱的，衰弱的; 无效的，无意的; 缺乏决心的，缺乏活力的	英 [ˈfi:bl]　美 [ˈfibəl]　
federation	联邦，同盟; 联盟，联合会; 联邦，联邦政府	英 [ˌfedəˈreɪʃn]　美 [ˌfɛdəˈreʃən]　
fusion	融合; 熔解，熔化; 融合物; [物]核聚变	英 [ˈfju:ʒn]　美 [ˈfjuʒən]　
fascinate	蛊惑; 使着迷; 使神魂颠倒	英 [ˈfæsɪneɪt]　美 [ˈfæsəˌnet]　
feminine	有女性气质的; 女子气的; [语]阴性的; 阴柔的	英 [ˈfemənɪn]　美 [ˈfɛmənɪn]　
fitting	装修; 试穿，试衣; 设备，器材; 装置	英 [ˈfɪtɪŋ]　美 [ˈfɪtɪŋ]　
fixture	（房屋等的）固定装置; [商]定期放款，定期存款; 固定在某位置的人或物; （定期定点举行的）体育活动	英 [ˈfɪkstʃə(r)]　美 [ˈfɪkstʃɚ]　
flank	侧翼; 侧面; 侧腹; 侧边	英 [flæŋk]　美 [flæŋk]　
flap	扁平物; [航] 襟翼; 拍打，拍打声; 〈口〉不安，恐慌	英 [flæp]　美 [flæp]　
flutter	飘动; 鼓翼	英 [ˈflʌtə(r)]　美 [ˈflʌtɚ]　
flaw	瑕疵，缺点; 一阵狂风; 短暂的风暴; 裂缝，裂纹	英 [flɔ:]　美 [flɔ]　
forerunner	先驱; 先驱者; 先兆，预兆	英 [ˈfɔ:rʌnə(r)]　美 [ˈfɔrˌrʌnɚ, ˈfor-]　
flare	闪耀，闪光; 燃烧; 突然发怒; 向外张开	英 [fleə(r)]　美 [fler]　
flush	冲刷; 脸红; 呈红色; 奔流	英 [flʌʃ]　美 [flʌʃ]　
formidable	可怕的; 令人敬畏的; 难以对付的	英 [ˈfɔ:mɪdəbl]　美 [ˈfɔ:rmɪdəbl]　
fort	堡垒，要塞; 边界贸易站	英 [fɔ:t]　美 [fɔ:rt]　
forthcoming	即将到来的; 现成的; 唾手可得的; 乐于助人的	英 [ˌfɔ:θˈkʌmɪŋ]　美 [ˌfɔ:rθˈkʌmɪŋ]　
foster	培养; 促进; 抚育; 代养	英 [ˈfɒstə(r)]　美 [ˈfɔ:stə(r)]　
friction	摩擦; 摩擦力; 冲突，不和	英 [ˈfrɪkʃn]　美 [ˈfrɪkʃən]　
fury	狂怒; 暴怒; [罗神]复仇三女神之一; 激怒者	英 [ˈfjʊəri]　美 [ˈfjʊri]　
foul	[体]违反规则的，犯规的; 邪恶的; 难闻的，有恶臭的; 下流的	英 [faʊl]　美 [faʊl]　
fracture	（使）折断，破碎	英 [ˈfræktʃə(r)]　美 [ˈfræktʃɚ]　
fragile	易碎的，脆的; 虚弱的	英 [ˈfrædʒaɪl]　美 [ˈfrædʒl]　
frantic	发狂的; 发疯似的; 厉害的; 非常的	英 [ˈfræntɪk]　美 [ˈfræntɪk]　
garment	服装; 衣服	英 [ˈgɑ:mənt]　美 [ˈgɑ:rmənt]　
garment	服装; 衣服	英 [ˈgɑ:mənt]　美 [ˈgɑ:rmənt]　
gasp	喘气，喘息; 倒抽气; 渴望	英 [gɑ:sp]　美 [gæsp]　
gauge	评估; 测量的标准或范围; 尺度，标准; 测量仪器	英 [ɡeɪdʒ]　美 [ɡedʒ]　
gleam	（使）闪烁，（使）闪亮	英 [gli:m]　美 [ɡlim]　
glare	怒目而视	英 [gleə(r)]　美 [gler]　
generalise	概括，归纳，推论	英 ['dʒenərəlaɪz]　美 ['dʒenərəlˌaɪz]　
genetic	基因的; 遗传的; 起源的，起因的; 演变的	英 [dʒəˈnetɪk]　美 [dʒəˈnɛtɪk]　
geology	地质学; （某地区的）地质情况; 地质学的著作	英 [dʒiˈɒlədʒi]　美 [dʒiˈɑ:lədʒi]　
gigantic	巨大的，庞大的; 巨人似的; 硕大无比; 排山倒海	英 [dʒaɪˈgæntɪk]　美 [dʒaɪˈɡæntɪk]　
gloomy	黑暗的; 令人沮丧的; 前景黯淡的; 悲观的，阴郁的	英 [ˈglu:mi]　美 [ˈɡlumi]　
gossip	流言蜚语，谣言; 爱讲闲话的人; 谈话，闲话; 关系亲密的伙伴	英 [ˈgɒsɪp]　美 [ˈgɑ:sɪp]　
gown	长袍，长外衣; 女长服; 罩袍; 大学的学生和教师	英 [gaʊn]　美 [ɡaʊn]　
graze	放牧; （让动物）吃草; 轻擦，擦破	英 [greɪz]　美 [ɡrez]　
grease	动物油脂; 油膏，润滑油; 〈俚〉贿赂	英 [gri:s]　美 [ɡris]　
grieve	使伤心; 使悲伤	英 [gri:v]　美 [ɡriv]　
grill	烧烤	英 [grɪl]　美 [ɡrɪl]　
groan	呻吟; 抱怨; 发牢骚; 吱嘎声：因压力而发出声响	英 [grəʊn]　美 [groʊn]　
groove	沟，槽; [俚语]常规，老套：确定的规范; [俚语]理想状况; [俚语]非常愉快的经历	英 [gru:v]　美 [ɡruv]　
grope	触摸，试探着前进; 探索，摸索	英 [grəʊp]　美 [groʊp]　
hamper	妨碍，束缚，限制; 使困累	英 [ˈhæmpə(r)]　美 [ˈhæmpɚ]　
handicap	障碍; 缺陷; 不利条件; 给弱者增加的杆数（按击球次数计数，并随参赛者的进步而减少）	英 [ˈhændikæp]　美 [ˈhændiˌkæp]　
harassment	袭扰; 骚扰，扰乱; 折磨人的东西; 烦恼，忧虑	英 ['hærəsmənt]　美 [hə'ræsmənt]　
hasty	草率的; 轻率的; 仓促完成的; 急忙的	英 [ˈheɪsti]　美 ['heɪsti]　
hatch	孵化; 孵出，破壳而出	英 [hætʃ]　美 [hætʃ]　
heir	继承人; 后嗣，嗣子	英 [eə(r)]　美 [er]　
henceforth	从今以后，今后	英 [ˌhensˈfɔ:θ]　美 [ˌhensˈfɔ:rθ]　
herb	草，草本植物; 药草，香草; 牧草	英 [hɜ:b]　美 [ɜ:rb]　
heritage	遗产; 传统; 文化遗产; 继承物	英 [ˈherɪtɪdʒ]　美 [ˈhɛrɪtɪdʒ]　
historian	历史学家，史学工作者	英 [hɪˈstɔ:riən]　美 [hɪˈstɔriən]　
homogeneous	均匀的; 同性质的，同类的; 由相同（或同类型）事物（或人）组成的; [数]齐性的，齐次的	英 [ˌhɒməˈdʒi:niəs]　美 [ˌhoʊməˈdʒi:niəs]　
hop	跳上[下]; 单足蹦跳; 齐足（或双足）跳行; 摘葎草花	英 [hɒp]　美 [hɑ:p]　
hose	软管，胶皮管; 长筒袜; 男性穿的紧身裤	英 [həʊz]　美 [hoʊz]　
hound	猎狗，猎犬; 卑劣的人; [动]角鲨，星鲨，弓鳍鱼; 有…迷[瘾]的人	英 [haʊnd]　美 [haʊnd]　
howl	哀号，吼叫	英 [haʊl]　美 [haʊl]　
hug	热烈地拥抱，抱住，紧抱	英 [hʌg]　美 [hʌɡ]　
hurl	丢下，用力投掷; 大声叫骂，愤慨的说出; 推到，推翻	英 [hɜ:l]　美 [hɜ:rl]　
hurricane	飓风，十二级风; 飓风般猛烈的东西; （感情等的）爆发; 飓风式战斗驱逐机	英 [ˈhʌrɪkən]　美 [ˈhɜ:rəkən]　
hysterical	癔病性; 歇斯底里般的; 癔病的; 情绪异常激动的	英 [hɪˈsterɪkl]　美 [hɪˈstɛrɪkəl]　
identification	认同; 鉴定，识别; 验明; 身份证明	英 [aɪˌdentɪfɪˈkeɪʃn]　美 [aɪˌdɛntəfɪˈkeʃən]　
idiot	白痴; 傻瓜，笨蛋	英 [ˈɪdiət]　美 [ˈɪdiət]　
illusion	错觉; 幻想; 假象; 错误观念	英 [ɪˈlu:ʒn]　美 [ɪˈluʒən]　
imitation	仿制品; 模仿，仿效; 赝品; [生]拟态	英 [ˌɪmɪˈteɪʃn]　美 [ˌɪmɪˈteʃən]　
impart	传授; 给予; 告知，透露	英 [ɪmˈpɑ:t]　美 [ɪmˈpɑ:rt]　
imperative	势在必行的; 必要的，不可避免的; 命令的，专横的; [语]祈使的	英 [ɪmˈperətɪv]　美 [ɪmˈpɛrətɪv]　
imperial	帝国的，皇帝的; 皇家的，庄严的; 特级的; 度量衡英制的	英 [ɪmˈpɪəriəl]　美 [ɪmˈpɪriəl]　
impetus	动力; 势头; 促进; 声势	英 [ˈɪmpɪtəs]　美 [ˈɪmpɪtəs]　
impulse	凭冲动行事; 突如其来的念头; [电子]脉冲; [医]冲动，搏动	英 [ˈɪmpʌls]　美 [ˈɪmˌpʌls]　
inaugurate	开创; 创始; 举行开幕典礼; 举行就职典礼	英 [ɪˈnɔ:gjəreɪt]　美 [ɪnˈɔɡjəˌret]　
incidentally	顺便; 附带; 捎带; 偶然地，不经意地	英 [ˌɪnsɪˈdentli]　美 [ˌɪnsɪˈdɛntli]　
incorporate	包含; 组成公司; 使混合; 使具体化	英 [ɪnˈkɔ:pəreɪt]　美 [ɪnˈkɔ:rpəreɪt]　
incur	遭受; 招致，引起	英 [ɪnˈkɜ:(r)]　美 [ɪnˈkɚ]　
indefinite	无限期的，无限期的; 不明确的，模糊的; 模糊的; [语]不定的	英 [ɪnˈdefɪnət]　美 [ɪnˈdɛfənɪt]　
indicative	象征的; 指示的，表示的; [语]陈述的，直陈的	英 [ɪnˈdɪkətɪv]　美 [ɪnˈdɪkətɪv]　
indulge	迁就，纵容; 使满足; 使（自己）沉溺于; 使快乐	英 [ɪnˈdʌldʒ]　美 [ɪnˈdʌldʒ]　
inertia	惯性，惰性; 迟钝; 不活动	英 [ɪˈnɜ:ʃə]　美 [ɪˈnɜ:rʃə]　
infectious	传染的; 有传染性的; 易传染的; 有感染力的	英 [ɪnˈfekʃəs]　美 [ɪnˈfɛkʃəs]　
ingenious	精巧的; 灵巧的; 设计独特的; 有天才的，聪明的	英 [ɪnˈdʒi:niəs]　美 [ɪnˈdʒinjəs]　
inherent	天生; 固有的，内在的	英 [ɪnˈhɪərənt]　美 [ɪnˈhɪrənt]　
innovation	改革，创新; 新观念; 新发明; 新设施	英 [ˌɪnəˈveɪʃn]　美 [ˌɪnəˈveʃən]　
innumerable	不可胜数; 无数的，数不清的; 指不胜屈; 无可胜数	英 [ɪˈnju:mərəbl]　美 [ɪˈnu:mərəbl]　
intact	完好无损; 原封不动的; 完整无缺的，未经触动的，未受损伤的; 完好无缺	英 [ɪnˈtækt]　美 [ɪn'tækt]　
intensify	（使）增强，（使）加剧; 增加（照片图象）的对比度; 变强或增强	英 [ɪnˈtensɪfaɪ]　美 [ɪnˈtɛnsəˌfaɪ]　
intelligible	可理解的，明白易懂的，清楚的	英 [ɪnˈtelɪdʒəbl]　美 [ɪnˈtɛlɪdʒəbəl]　
intellect	知识分子; 智力，理解力; 有才智的人	英 [ˈɪntəlekt]　美 [ˈɪntlˌɛkt]　
intersection	横断，横切; 交叉，相交; 交叉点，交叉线; [数]交集	英 [ˌɪntəˈsekʃn]　美 [ˌɪntərˈsekʃn]　
inspiration	灵感; 吸气; 鼓舞人心的人或事; 启发灵感的人（或事物）	英 [ˌɪnspəˈreɪʃn]　美 [ˌɪnspəˈreʃən]　
instalment	分期付款; 装设; 就职; （小说等）分期连载的一部分	英 [ɪnˈstɔ:lmənt]　美 [ɪnˈstɔːlmənt]　
instrumental	仪器的; 乐器的; 有帮助的; 起作用的	英 [ˌɪnstrəˈmentl]　美 [ˌɪnstrəˈmɛntl]　
insulate	使隔离，使孤立; 使绝缘，使隔热	英 [ˈɪnsjuleɪt]　美 [ˈɪnsəleɪt]　
intercourse	交流，交往，交际; [生]交合	英 [ˈɪntəkɔ:s]　美 [ˈɪntərkɔ:rs]　
intimidate	恐吓，威胁	英 [ɪnˈtɪmɪdeɪt]　美 [ɪnˈtɪmɪˌdet]　
inventory	清查; 存货清单; 财产目录，财产目录的编制; 存货总值	英 [ˈɪnvəntri]　美 [ˈɪnvəntɔ:ri]　
invalid	无效的; 不能成立的; 有病的; 病人用的	英 [ɪnˈvælɪd]　美 [ˈɪnvəlɪd]　
irritate	刺激，使兴奋; 使发怒; 使感到不适; 使疼痛，使发炎	英 [ˈɪrɪteɪt]　美 [ˈɪrɪˌtet]　
irrigation	灌溉; 水利; [医]冲洗; 冲注洗剂	英 [ˌɪrɪ'ɡeɪʃn]　美 [ˌɪrɪ'ɡeɪʃn]　
irrespective	无关的; 不考虑的，不顾的	英 [ˌɪrɪ'spektɪv]　美 [ˌɪrɪˈspɛktɪv]　
ivory	象牙; 象牙色; 象牙制品; 象牙质	英 [ˈaɪvəri]　美 [ˈaɪvəri, ˈaɪvri]　
jeopardize	危及，损害; 使陷入险境或受伤; 使…遇险	英 [ˈdʒepədaɪz]　美 [ˈdʒepərdaɪz]　
jerk	猛拉; 把（牛肉）切成薄片晒干	英 [dʒɜ:k]　美 [dʒɜ:rk]　
kidney	肾，肾脏; （可食用的动物的）腰子; 脾气，性格	英 [ˈkɪdni]　美 [ˈkɪdni]　
kit	衣物和装备; 成套用品; 配套元件	英 [kɪt]　美 [kɪt]　
knit	编织，编结; 接合（折骨等）; 使皱起，使皱紧; 使紧密相联	英 [nɪt]　美 [nɪt]　
knob	球形把手; （收音机等的）旋钮; 小块; 疙瘩	英 [nɒb]　美 [nɑ:b]　
lash	鞭挞，鞭子; 责骂; 讽刺; 眼睫毛	英 [læʃ]　美 [læʃ]　
layman	俗人; 门外汉，外行; 一般信徒	英 [ˈleɪmən]　美 [ˈlemən]　
layman	俗人; 门外汉，外行; 一般信徒	英 [ˈleɪmən]　美 [ˈlemən]　
leaflet	传单，散页印刷品; 小叶，嫩叶; 复叶的一片; 叶状器官	英 [ˈli:flət]　美 [ˈliflɪt]　
legend	传说; 传奇人物; 图例; 铭文	英 [ˈledʒənd]　美 [ˈlɛdʒənd]　
legitimate	合法的，合理的; 正规的; 合法婚姻所生的; 真正的，真实的	英 [lɪˈdʒɪtɪmət]　美 [ləˈdʒɪtəmɪt]　
lever	杠杆; 操作杆; 工具	英 [ˈli:və(r)]　美 [ˈlevər]　
levy	征税; 征兵	英 [ˈlevi]　美 [ˈlɛvi]　
liability	责任; 债务; 倾向; 妨碍	英 [ˌlaɪəˈbɪləti]　美 [ˌlaɪəˈbɪlɪti]　
limp	跛行; 挣扎着慢慢前进; （诗的）韵律紊乱	英 [lɪmp]　美 [lɪmp]　
linear	直线的，线形的; 长度的; 一次的，线性的; 通过单独的若干阶段来发展	英 [ˈlɪniə(r)]　美 [ˈlɪniər]　
linen	亚麻布，亚麻线; 家庭日用织品	英 [ˈlɪnɪn]　美 [ˈlɪnən]　
locality	地区; 位置; 产地	英 [ləʊˈkæləti]　美 [loʊˈkæləti]　
locomotive	机车; 火车头	英 [ˌləʊkəˈməʊtɪv]　美 [ˌloʊkəˈmoʊtɪv]　
lubricate	加油润滑; 使润滑	英 [ˈlu:brɪkeɪt]　美 [ˈlubrɪˌket]　
literally	逐字地; 照字面地; 确实地，真正地; [口语]差不多，简直（用于加强语意）	英 [ˈlɪtərəli]　美 [ˈlɪtərəli]　
luminous	发光的; 明亮的; 清楚的; 辉赫	英 [ˈlu:mɪnəs]　美 [ˈlumənəs]　
magistrate	地方法官，治安官; 文职官员; 治安推事	英 [ˈmædʒɪstreɪt]　美 [ˈmædʒɪˌstret, -strɪt]　
manoeuvre	调遣，换防，对抗演习，操纵; 技术动作; 策略，巧计; 花招，伎俩	英 [məˈnu:və(r)]　美 [məˈnuvɚ, -ˈnju-]　
mansion	大厦; 宅第，公馆	英 [ˈmænʃn]　美 [ˈmænʃən]　
marble	大理石; 大理石制品; 弹子游戏; 理智，常识	英 [ˈmɑ:bl]　美 [ˈmɑ:rbl]　
marsh	沼泽，湿地	英 [mɑ:ʃ]　美 [mɑ:rʃ]　
marshal	元帅; 典礼官; 执法官; 消防局长	英 [ˈmɑ:ʃl]　美 [ˈmɑ:rʃl]　
masculine	男子气概的; 阳性的，雄性的; 男性化的，像男人的	英 [ˈmæskjəlɪn]　美 [ˈmæskjəlɪn]　
melody	歌曲; 旋律，曲调; 美妙的音乐，和谐的调子; 好听的声音	英 [ˈmelədi]　美 [ˈmɛlədi]　
memorise	记住，熟记	英 ['meməraɪz]　美 ['meməraɪz]　
mercury	[化]汞，水银; [天]水星; 温度表; 精神，元气	英 [ˈmɜ:kjəri]　美 [ˈmɜ:rkjəri]　
messenger	信使，信差; 先驱; [军]通信兵，传令兵	英 [ˈmesɪndʒə(r)]　美 [ˈmɛsəndʒɚ]　
metallic	金属的; 金属性的; 金属制的; 含金属的	英 [məˈtælɪk]　美 [məˈtælɪk]　
metropolitan	大都会的; 大城市的; 宗主国的; 大主教教区的	英 [ˌmetrəˈpɒlɪtən]　美 [ˌmetrəˈpɑ:lɪtən]　
midst	中部，中间，当中	英 [mɪdst]　美 [mɪdst, mɪtst]　
migrant	候鸟; 移居者，移民; 随季节迁移的工作者; 迁移动物	英 [ˈmaɪgrənt]　美 [ˈmaɪɡrənt]　
migrate	移动; 迁移，移往; 随季节而移居	英 [maɪˈgreɪt]　美 [ˈmaɪgreɪt]　
miniature	小型的，微小的	英 [ˈmɪnətʃə(r)]　美 [ˈmɪniəˌtʃʊr, -tʃɚ, ˈmɪnə-]　
minimise	把…减至最低数量[程度]; 对（某事物）作最低估计，极力贬低（某事物）的价值[重要性]	英 ['mɪnɪmaɪz]　美 ['mɪnɪmaɪz]　
minimize	把…减至最低数量[程度]; 对（某事物）作最低估计，极力贬低（某事物）的价值[重要性]; 极度轻视	英 [ˈmɪnɪmaɪz]　美 [ˈmɪnəˌmaɪz]　
mint	薄荷; 铸币厂; 大量，尤指钱; 来源	英 [mɪnt]　美 [mɪnt]　
misery	痛苦; 不幸; 穷困; 悲惨的境遇	英 [ˈmɪzəri]　美 [ˈmɪzəri]　
missionary	传教士; 宣传者	英 [ˈmɪʃənri]　美 [ˈmɪʃəneri]　
mistress	情妇; 主妇，女主人; 霸主，女统治者; 女教师	英 [ˈmɪstrəs]　美 [ˈmɪstrɪs]　
mob	暴徒; 犯罪团伙，黑手党; 民众，乌合之众; 〈美俚〉匪帮，一群罪犯	英 [mɒb]　美 [mɑ:b]　
mobilise	动员起来，调动，鼓动起	英 ['məʊbɪlɑɪz]　美 ['moʊbɪlɑɪz]　
mobilize	调动; 动员; 组织，动员起来	英 [ˈməʊbəlaɪz]　美 [ˈmoʊbəlaɪz]　
momentum	势头; 动力; [物]动量; 要素，契机	英 [məˈmentəm]　美 [moʊˈmentəm]　
monster	巨大的，庞大的; （建筑物）巍峨的	英 [ˈmɒnstə(r)]　美 [ˈmɑ:nstə(r)]　
morality	道德; 道德观; 道德准则; 品德高尚的行为	英 [məˈræləti]　美 [məˈrælɪti, mɔ-]　
mortgage	抵押; 抵押单据，抵押证明; 抵押权，债权	英 [ˈmɔ:gɪdʒ]　美 [ˈmɔ:rgɪdʒ]　
motel	汽车旅馆	英 [məʊˈtel]　美 [moʊˈtel]　
muddy	泥泞的; 暗的; 模糊的; 糊涂的	英 [ˈmʌdi]　美 [ˈmʌdi]　
municipal	市的，市政的; 地方自治的; 都市的，市营的，市制的; 内政的	英 [mju:ˈnɪsɪpl]　美 [mjuˈnɪsəpəl]　
murmur	咕哝，发牢骚; 低声的抱怨; 低声说话	英 [ˈmɜ:mə(r)]　美 [ˈmɜ:rmə(r)]　
muscular	肌肉的; 壮健的，肌肉发达的，强壮的	英 [ˈmʌskjələ(r)]　美 [ˈmʌskjəlɚ]　
naive	天真的; 幼稚的; 单纯的	英 [naɪˈi:v]　美 [nɑˈiv]　
napkin	尿布; 餐巾，餐巾纸; （女士）卫生巾	英 [ˈnæpkɪn]　美 [ˈnæpkɪn]　
narrative	故事; 记叙文; 叙述，记事; 叙述手法	英 [ˈnærətɪv]　美 [ˈnærətɪv]　
nasty	肮脏的; 下流的，令人讨厌的; 恶劣的，艰险的; 严重的	英 [ˈnɑ:sti]　美 [ˈnæsti]　
nil	无，零; 零分	英 [nɪl]　美 [nɪl]　
nominal	名义上的; 微不足道的; 票面上的; 名字的，列名的	英 [ˈnɒmɪnl]　美 [ˈnɑ:mɪnl]　
nominate	任命; 提名…为候选人; 挑选; 指定（时间、日期、名称等）	英 [ˈnɒmɪneɪt]　美 [ˈnɑ:mɪneɪt]　
notation	记号，标记法	英 [nəʊˈteɪʃn]　美 [noʊˈteɪʃn]　
odor	气味，名声	英 ['əʊdə]　美 ['oʊdə]　
offset	抵消; 补偿; （为了比较的目的而）把…并列（或并置）; 为（管道等）装支管	英 [ˈɒfset]　美 [ˈɔ:fset]　
olive	橄榄; 橄榄色; 橄榄树; 油橄榄	英 [ˈɒlɪv]　美 [ˈɑ:lɪv]　
opaque	不透明的; 无光泽的，晦暗的; 不传导性的; 含糊的，迟钝的	英 [əʊˈpeɪk]　美 [oʊˈpeɪk]　
optimism	乐观; 乐观主义	英 [ˈɒptɪmɪzəm]　美 [ˈɑ:ptɪmɪzəm]　
orient	标定方向; 使…向东方; 以…为参照; 使熟悉或适应	英 [ˈɔ:rient]　美 [ˈɔriənt, -ˌɛnt, ˈor-]　
oriental	东方的; 东方人的; 东方文化的; 优质的	英 [ˌɔ:riˈentl]　美 [ˌɔriˈɛntl, ˌor-]　
orientation	方向，定位，取向，排列方向; 任职培训; （外交等的）方针[态度]的确定; 环境判定	英 [ˌɔ:riənˈteɪʃn]　美 [ˌɔriɛnˈteʃən, -ən-, ˌor-]　
ornament	装饰; 装饰物; [乐]装饰音	英 [ˈɔ:nəmənt]　美 [ˈɔ:rnəmənt]　
outbreak	（战争，怒气等的）爆发; 突然发生	英 [ˈaʊtbreɪk]　美 [ˈaʊtˌbrek]　
outrage	愤慨; 暴行; 义愤; 骇人听闻的事件	英 [ˈaʊtreɪdʒ]　美 [ˈaʊtˌredʒ]　
overflow	溢出，淹没; 挤满，充满; 洋溢; 资源过剩	英 [ˌəʊvəˈfləʊ]　美 [ˌoʊvərˈfloʊ]　
overpass	立交桥，天桥，高架道路	英 [ˈəʊvəpɑ:s]　美 [ˈoʊvərpæs]　
overt	公开的; 明显的; 公然的; 阳	英 [əʊˈvɜ:t]　美 [oʊˈvɜ:rt]　
overwhelming	势不可挡的，压倒一切的，巨大的; 压倒一切的欢乐	英 [ˌəʊvəˈwelmɪŋ]　美 [ˌoʊvərˈwelmɪŋ]　
oxide	[化]氧化物	英 [ˈɒksaɪd]　美 [ˈɑ:ksaɪd]　
ozone	[化]臭氧; 清新空气	英 [ˈəʊzəʊn]　美 [ˈoʊzoʊn]　
pact	公约; 条约，公约	英 [pækt]　美 [pækt]　
partition	分割; 隔墙; 划分，分开; 隔离物	英 [pɑ:ˈtɪʃn]　美 [pɑ:rˈtɪʃn]　
pastime	消遣，娱乐	英 [ˈpɑ:staɪm]　美 [ˈpæstaɪm]　
pamphlet	小册子; 活页文选	英 [ˈpæmflət]　美 [ˈpæmflɪt]　
paperback	平装本，平装书	英 [ˈpeɪpəbæk]　美 [ˈpeɪpərbæk]　
paradox	反论，悖论; 似非而是的论点; 自相矛盾的人或事; [物]佯谬	英 [ˈpærədɒks]　美 [ˈpærədɑ:ks]　
patent	专利; 专利权; 专利品; 专利证	英 [ˈpætnt]　美 [ˈpætnt]　
patrol	巡逻，巡查; 巡逻队，侦察队; 童子军小队	英 [pəˈtrəʊl]　美 [pəˈtroʊl]　
pave	铺设; 为…铺平道路; 安排	英 [peɪv]　美 [pev]　
peanut	花生; 微不足道的人，小人物; 很少的钱	英 [ˈpi:nʌt]　美 [ˈpiˌnʌt]　
pedal	踏板; 脚蹬子; 垂足线	英 [ˈpedl]　美 [ˈpɛdl]　
pedestrian	行人; 步行者	英 [pəˈdestriən]　美 [pəˈdɛstriən]　
peel	剥皮; 覆盖层脱落，剥落	英 [pi:l]　美 [pil]　
pendulum	摆，钟摆; 摇摆不定的事态（或局面）	英 [ˈpendjələm]　美 [ˈpendʒələm]　
perfection	完善; 完美; 圆满; 最后加工	英 [pəˈfekʃn]　美 [pərˈfekʃn]　
perfume	香水; 香料; 香味，香气	英 [ˈpɜ:fju:m]　美 [pərˈfju:m]　
periodic	周期的; 定期的; 回归的; 间歇的，时而发生的	英 [ˌpɪəriˈɒdɪk]　美 [ˌpɪriˈɑ:dɪk]　
periodical	期刊; 杂志	英 [ˌpɪəriˈɒdɪkl]　美 [ˌpɪriˈɑ:dɪkl]　
perish	毁灭; 死亡，丧生; 腐烂，枯萎; 老化	英 [ˈperɪʃ]　美 [ˈpɛrɪʃ]　
permeate	渗透; 渗入; 弥漫; 遍布	英 [ˈpɜ:mieɪt]　美 [ˈpɜ:rmieɪt]　
permissible	许可的; 可允许的; 不碍事的; 得到准许的	英 [pəˈmɪsəbl]　美 [pərˈmɪsəbl]　
petition	请愿书，; 请愿，请求; 上诉状	英 [pəˈtɪʃn]　美 [pəˈtɪʃən]　
pirate	海盗船; 盗版者; 海盗，强盗; 侵害版权者	英 [ˈpaɪrət]　美 [ˈpaɪrɪt]　
pistol	手枪	英 [ˈpɪstl]　美 [ˈpɪstəl]　
plaster	石膏; 膏药; 灰泥，涂墙泥	英 [ˈplɑ:stə(r)]　美 [ˈplæstə(r)]　
plausible	貌似真实的; 貌似有理的; 花言巧语的; 有眉有眼	英 [ˈplɔ:zəbl]　美 [ˈplɔzəbəl]　
plea	恳求，请求; （被告或被告律师的）抗辩，答辩; 借口，托辞; 请愿	英 [pli:]　美 [pli]　
plight	境况，困境; 誓约	英 [plaɪt]　美 [plaɪt]　
porch	门廊; 游廊，走廊	英 [pɔ:tʃ]　美 [pɔ:rtʃ]　
portray	描绘; 描述; 画像; 描画	英 [pɔ:ˈtreɪ]　美 [pɔ:rˈtreɪ]　
precede	在…之前发生或出现，先于; 在…之上，优于; 给…作序; 处于…前面的位置	英 [prɪˈsi:d]　美 [prɪˈsid]　
precedent	先例; 前例	英 [ˈpresɪdənt]　美 [ˈprɛsɪdənt]　
preclude	排除; 妨碍; 阻止	英 [prɪˈklu:d]　美 [prɪˈklud]　
predominant	主要的，占主导地位的; 占优势的，卓越的; 有影响的; 特优种	英 [prɪˈdɒmɪnənt]　美 [prɪˈdɑ:mɪnənt]　
premier	总理; 首相	英 [ˈpremiə(r)]　美 [prɪˈmɪr]　
premise	前提; [复数]房屋; [复数][合同、契约用语]上述各点; （逻辑学中的）大[小]前提	英 ['premɪs]　美 [ˈprɛmɪs]　
premium	保险费; 额外费用; 附加费	英 [ˈpri:miəm]　美 [ˈprimiəm]　
prescription	处方药; [医]药方，处方; 训令，指示; 法规	英 [prɪˈskrɪpʃn]　美 [prɪˈskrɪpʃən]　
prestige	声誉; 威信，威望，声望; （财势的）显赫; 信望	英 [preˈsti:ʒ]　美 [prɛˈstiʒ, -ˈstidʒ]　
prevalent	流行的，盛行的; 普遍存在的，普遍发生的	英 [ˈprevələnt]　美 [ˈprɛvələnt]　
preview	试映，预演; 预告片; 象征，预示	英 [ˈpri:vju:]　美 [ˈpriˌvju]　
prey	被捕食的动物; 捕食（习性）; 受害者; 受骗者	英 [preɪ]　美 [pre]　
privacy	隐私，秘密; 隐居; 私事; 不受公众干扰的状态	英 [ˈprɪvəsi]　美 [ˈpraɪvəsi]　
probe	探头; [医]（对伤处等的）针探，探查; [医]探针，取样器; 探测仪	英 [prəʊb]　美 [proʊb]　
productive	多产的; 富有成效的; 生产性的; 具有创造性的	英 [prəˈdʌktɪv]　美 [prəˈdʌktɪv, pro-]　
profitable	有利可图的，有益的; 可赚钱的，合算的	英 [ˈprɒfɪtəbl]　美 [ˈprɑ:fɪtəbl]　
profound	深厚的; 意义深远的; 严重的; 知识渊博的	英 [prəˈfaʊnd]　美 [prəˈfaʊnd, pro-]　
promising	有前途的; 有为; 有希望的; 光明	英 [ˈprɒmɪsɪŋ]　美 [ˈprɑ:mɪsɪŋ]　
prone	俯卧的; 易于…的; 有…倾向的; 倾斜的，坡陡的	英 [prəʊn]　美 [proʊn]　
propel	推动; 推进; 驱使; 驱动	英 [prəˈpel]　美 [prəˈpɛl]　
prophet	预言家，先知; 倡导者，主张者	英 [ˈprɒfɪt]　美 [ˈprɑ:fɪt]　
proposition	命题; 主张; 建议	英 [ˌprɒpəˈzɪʃn]　美 [ˌprɑ:pəˈzɪʃn]　
prose	散文; 单调，平凡; 枯燥无味的话，无聊的议论	英 [prəʊz]　美 [proʊz]　
prosecute	起诉; 控告; 继续从事; 担任控方律师	英 [ˈprɒsɪkju:t]　美 [ˈprɑ:sɪkju:t]　
provocative	挑衅的; 刺激性的	英 [prəˈvɒkətɪv]　美 [prəˈvɑ:kətɪv]　
psychiatrist	精神病医生; 精神病专家，精神病医生	英 [saɪˈkaɪətrɪst]　美 [saɪ'kaɪətrɪst]　
pudding	（一道）甜食，甜点心; 布丁（通常用面粉经烘烤或蒸煮做成的美味甜食品）; 肥胖而迟钝的人; [航]船尾碰垫	英 [ˈpʊdɪŋ]　美 [ˈpʊdɪŋ]　
pumpkin	南瓜; 南瓜的果肉，南瓜囊; 〈俚〉重要人物	英 [ˈpʌmpkɪn]　美 [ˈpʌmpkɪn, ˈpʌm-, ˈpʌŋ-]　
quantify	确定…的数量; [逻辑学] 用量词限定	英 [ˈkwɒntɪfaɪ]　美 [ˈkwɑ:ntɪfaɪ]　
quantitative	定量的; 数量（上）的	英 [ˈkwɒntɪtətɪv]　美 [ˈkwɑ:ntəteɪtɪv]　
quench	解（渴）; 终止（某事物）; （用水）扑灭（火焰等）; 将（热物体）放入水中急速冷却	英 [kwentʃ]　美 [kwɛntʃ]　
quest	追求; 探索; 远征; 验尸陪审团	英 [kwest]　美 [kwɛst]　
questionnaire	调查问卷; 调查表	英 [ˌkwestʃəˈneə(r)]　美 [ˌkwestʃəˈner]　
quiver	微颤，抖动	英 [ˈkwɪvə(r)]　美 [ˈkwɪvɚ]　
quota	配额; 指标; （正式限定的）定量，定额	英 [ˈkwəʊtə]　美 [ˈkwoʊtə]　
racket	（网球等）球拍; 〈美俚〉勒索金钱，讹诈，敲诈，骗局; （四周有围墙的）拍打回力网球，硬壁回力球; 喧骚，吵闹，嚷闹，扰嚷，喧骚嘈杂的集会，狂欢	英 [ˈrækɪt]　美 [ˈrækɪt]　
radiant	辐射的; 容光焕发的; 照耀的	英 [ˈreɪdiənt]　美 [ˈrediənt]　
radiate	辐射; 发射; 使向周围扩展	英 [ˈreɪdieɪt]　美 [ˈrediˌet]　
radioactive	放射性的	英 [ˌreɪdiəʊˈæktɪv]　美 [ˌreɪdoʊˈæktɪv]　
radius	桡骨; 半径范围; 半径（距离）; 用半径度量的圆形面积	英 [ˈreɪdiəs]　美 [ˈrediəs]　
random	随机的; 任意的; 胡乱的	英 [ˈrændəm]　美 [ˈrændəm]　
reassure	使安心，使消除疑虑; 再对…进行保险; 再保证	英 [ˌri:əˈʃʊə(r)]　美 [ˌri:əˈʃʊr]　
recede	后退; 减弱; （价值，品质等）跌落，低落，变坏; 收回意见，退出（某种活动）	英 [rɪˈsi:d]　美 [rɪˈsid]　
recipe	食谱; 处方; 秘诀	英 [ˈresəpi]　美 [ˈresəpi]　
recipient	接受者; 容器; 容纳者	英 [rɪˈsɪpiənt]　美 [rɪˈsɪpiənt]　
recite	背诵; 叙述; 列举	英 [rɪˈsaɪt]　美 [rɪˈsaɪt]　
rectangular	长方;  矩形的; 成直角的; 直角坐标的	英 [rek'tæŋɡjələ(r)]　美 [rɛkˈtæŋɡjəlɚ]　
rectify	改正，校正; [化]精馏; [电]整流	英 [ˈrektɪfaɪ]　美 [ˈrɛktəˌfaɪ]　
recur	复发; 重现; 再发生; 回想	英 [rɪˈkɜ:(r)]　美 [rɪˈkɚ]　
recycle	回收利用; 使再循环	英 [ˌri:ˈsaɪkl]　美 [riˈsaɪkəl]　
redundant	多余的，累赘的; （因人员过剩）被解雇的，失业的; 重沓; 衍	英 [rɪˈdʌndənt]　美 [rɪˈdʌndənt]　
reel	卷轴; 卷筒; 卷盘; 绕在卷轴上的线（或金属丝、胶卷等）	英 [ri:l]　美 [ril]　
refreshment	提神，精神恢复; 提神物; 点心，茶点	英 [rɪˈfreʃmənt]　美 [rɪˈfrɛʃmənt]　
refute	驳斥，驳倒；否认真实性；	英 [rɪˈfju:t]　美 [rɪˈfjut]　
regiment	（军队的）团; 大量的人或物	英 [ˈredʒɪmənt]　美 [ˈrɛdʒəmənt]　
rehearsal	排练，排演; 彩排，演习; 复述，详述	英 [rɪˈhɜ:sl]　美 [rɪˈhɜ:rsl]　
reign	当政，统治; 占主导地位	英 [reɪn]　美 [ren]　
rejoice	高兴; 欢庆	英 [rɪˈdʒɔɪs]　美 [rɪˈdʒɔɪs]　
resemblance	相似，形似; 外表，外观; 相似物，相似点; 肖像	英 [rɪˈzembləns]　美 [rɪˈzɛmbləns]　
reproach	责备，责骂; 使丢脸; 申斥; 损伤…的体面	英 [rɪˈprəʊtʃ]　美 [rɪˈproʊtʃ]　
reliance	依靠，依赖; 信任，信赖，信心; 所信赖的人或物	英 [rɪˈlaɪəns]　美 [rɪˈlaɪəns]　
remainder	剩余物; 其他人员; 差数; 廉价出售的图书	英 [rɪˈmeɪndə(r)]　美 [rɪˈmendɚ]　
remnant	残余; 剩余部分; 幸存者; 零料，零头布	英 [ˈremnənt]　美 [ˈrɛmnənt]　
repel	击退; 抵制; 使厌恶; 使不愉快	英 [rɪˈpel]　美 [rɪˈpɛl]　
repression	压抑; 约束; 抑制，镇压	英 [rɪˈpreʃn]　美 [rɪˈprɛʃən]　
residential	住宅的，适于作住宅的; 与居住有关的; 适宜作住宅的	英 [ˌrezɪˈdenʃl]　美 [ˌrɛzɪˈdɛnʃəl]　
retrospect	回顾，回想	英 [ˈretrəspekt]　美 [ˈrɛtrəˌspɛkt]　
revenge	报仇，报复	英 [rɪˈvendʒ]　美 [rɪˈvɛndʒ]　
rim	轮缘; （圆形器皿的）边，缘，框	英 [rɪm]　美 [rɪm]　
ritual	典礼; （宗教等的）仪式; 例行公事，老规矩	英 [ˈrɪtʃuəl]　美 [ˈrɪtʃuəl]　
robust	精力充沛的; 坚定的; 粗野的，粗鲁的; 需要体力的	英 [rəʊˈbʌst]　美 [roʊˈbʌst]　
rotary	旋转的	英 [ˈrəʊtəri]　美 [ˈroʊtəri]　
salute	欢迎，致敬	英 [səˈlu:t]　美 [səˈlut]　
salvation	拯救，救助; 救星，救世主; 解救办法，救济措施; 救济品	英 [sælˈveɪʃn]　美 [sælˈveʃən]　
scent	嗅觉; 香味，气味; （动物的）臭迹; 痕迹，踪迹	英 [sent]　美 [sɛnt]　
sceptical	怀疑的; 怀疑论者的	英 [ˈskeptɪkl]　美 [ˈskɛptɪkəl]　
scorn	轻蔑; 鄙视; 不屑一顾; 笑柄	英 [skɔ:n]　美 [skɔ:rn]　
scrap	废料; 小片; 残余物; 吵架	英 [skræp]　美 [skræp]　
scrub	用力擦洗，刷洗; 取消（原有安排）	英 [skrʌb]　美 [skrʌb]　
scrutiny	监督; 细看，细阅; 仔细的观察	英 [ˈskru:təni]　美 [ˈskrutni]　
sculpture	雕刻（术），塑像; 雕刻品; 刻纹	英 [ˈskʌlptʃə(r)]　美 [ˈskʌlptʃɚ]　
segregate	隔离; 分离; （使）分开; 隔离并区别对待（不同种族、宗教或性别的人）	英 [ˈsegrɪgeɪt]　美 [ˈsɛɡrɪˌɡet]　
sensation	感觉; 轰动; 知觉; 直觉	英 [senˈseɪʃn]　美 [sɛnˈseʃən]　
sentiment	情操; 感情，情绪; 意见，观点; 感伤	英 [ˈsentɪmənt]　美 [ˈsɛntəmənt]　
serial	连续的; 连载的; 顺序排列的; 分期偿付的	英 [ˈsɪəriəl]　美 [ˈsɪriəl]　
setback	挫折; 退步; 阻碍; 逆流	英 [ˈsetbæk]　美 [ˈsɛtˌbæk]　
shabby	卑鄙的; 破旧的，衣衫褴褛的; 悭吝的; 低劣的，下流的	英 [ˈʃæbi]　美 [ˈʃæbi]　
shaft	柄，轴; 矛，箭; 〈非〉嘲笑; 光线	英 [ʃɑ:ft]　美 [ʃæft]　
shark	鲨鱼; 坑蒙拐骗的人，诈骗者; [俚]老手	英 [ʃɑ:k]　美 [ʃɑ:rk]　
shatter	使破碎，使碎裂，砸碎; 使…成为泡影; 使…痛不欲生; 使…散开	英 [ˈʃætə(r)]　美 [ˈʃætɚ]　
shepherd	牧羊人，羊倌; 牧师; 指导者	英 [ˈʃepəd]　美 [ˈʃepərd]　
shove	推，猛推	英 [ʃʌv]　美 [ʃʌv]　
shutter	快门; 百叶窗; 遮光器	英 [ˈʃʌtə(r)]　美 [ˈʃʌtɚ]　
siege	围攻，围困，围城（期间）; 不断袭击; 长期努力	英 [si:dʒ]　美 [sidʒ]　
sieve	滤网; [粮食][矿]筛子; 不能保守秘密的人，嘴不严的人	英 [sɪv]　美 [sɪv]　
silicon	硅; 硅元素	英 [ˈsɪlɪkən]　美 [ˈsɪlɪkən, -ˌkɑn]　
skeleton	骨骼; （建筑物等的）骨架; 梗概; 骨瘦如柴的人（或动物）	英 [ˈskelɪtn]　美 [ˈskɛlɪtn]　
skeptical	怀疑性的，好怀疑的，无神论的	英 ['skeptɪkəl]　美 ['skeptɪkəl]　
skip	跳; 跳绳; 悄悄溜走; 快速转移	英 [skɪp]　美 [skɪp]　
slack	懈怠的; 松（弛）的; 清淡的; 不活跃的	英 [slæk]　美 [slæk]　
slash	大幅削减; 挥砍; 鞭打; 严厉批评	英 [slæʃ]　美 [slæʃ]　
slaughter	大屠杀; 屠宰（动物）; 大减价，贱卖; 〈口〉强烈谴责，猛烈抨击	英 [ˈslɔ:tə(r)]　美 [ˈslɔtɚ]　
slick	光滑的; 华而不实的; 熟练的，灵巧的; 机灵的，聪明的	英 [slɪk]　美 [slɪk]　
slogan	标语，口号; 呐喊声; （商业广告上用的）短语	英 [ˈsləʊgən]　美 [ˈsloʊgən]　
slot	位置; 狭槽，水沟; [人名] 斯洛特; 硬币投币口	英 [slɒt]　美 [slɑ:t]　
slot	位置; 狭槽，水沟; [人名] 斯洛特; 硬币投币口	英 [slɒt]　美 [slɑ:t]　
slump	大幅度下降，暴跌; 沉重或突然地落下[倒下]	英 [slʌmp]　美 [slʌmp]　
smuggle	走私; 偷运; 私运; 不按规章地偷带（人或物）	英 [ˈsmʌgl]　美 [ˈsmʌɡəl]　
snack	快餐，点心; 加餐	英 [snæk]　美 [snæk]　
sniff	嗅; 发现; 鄙视地说; 深深吸入; 忿忿不平地说	英 [snɪf]　美 [snɪf]　
sociology	社会学; 群体生态学	英 [ˌsəʊsiˈɒlədʒi]　美 [ˌsoʊsiˈɑ:lədʒi]　
solicitor	初级律师; 恳求者，求婚者; 〈美〉掮客，募捐人	英 [səˈlɪsɪtə(r)]　美 [səˈlɪsɪtɚ]　
solidarity	团结	英 [ˌsɒlɪˈdærəti]　美 [ˌsɑ:lɪˈdærəti]　
soluble	[化] 可溶的; 可以解决的; 可以解释的; [数]可解的	英 [ˈsɒljəbl]　美 [ˈsɑ:ljəbl]　
sovereign	君主; 最高统治者; 独立国; 旧时价值为一镑的英国金币	英 [ˈsɒvrɪn]　美 [ˈsɑ:vrən]　
spacious	宽敞的; 广阔的; （知识）广博的	英 [ˈspeɪʃəs]　美 [ˈspeʃəs]　
specialty	专业，专长; 特点，特别事项; 特性，特质; 盖印的契约	英 [ˈspeʃəlti]　美 [ˈspɛʃəlti]　
spectacle	眼镜; 奇观，壮观; 光景，景象; 表演，场面	英 [ˈspektəkl]　美 [ˈspɛktəkəl]　
spectrum	光谱; 波谱; 范围; 系列	英 [ˈspektrəm]　美 [ˈspɛktrəm]　
spiral	旋涡; 螺旋（线）; 螺旋形物; （足球运动的）旋球	英 [ˈspaɪrəl]　美 [ˈspaɪrəl]　
splash	使（液体）溅起	英 [splæʃ]　美 [splæʃ]　
sprinkle	洒，撒; 用…点缀; 下小雨	英 [ˈsprɪŋkl]　美 [ˈsprɪŋkəl]　
spy	间谍; 密探	英 [spaɪ]　美 [spaɪ]　
stab	刺; 刺; 将…刺入; 对…做出刺或戳的动作	英 [stæb]　美 [stæb]　
stabilise	（使）稳定，（使）稳固	英 ['stæbɪlaɪz]　美 ['steɪblˌaɪz]　
stability	稳定（性），稳固; 坚定，恒心	英 [stəˈbɪləti]　美 [stəˈbɪlɪti]　
stagger	蹒跚; 动摇; 犹豫	英 [ˈstægə(r)]　美 [ˈstæɡɚ]　
staircase	楼梯; 楼梯间	英 [ˈsteəkeɪs]　美 [ˈsterkeɪs]　
staple	主食; 主要产品; 钉书钉，U 形钉; 主题，主要部份	英 [ˈsteɪpl]　美 [ˈstepəl]　
stereotype	陈规旧习，旧规矩; 固定的形式; 铅版; 铅版制版法，铅板印刷	英 [ˈsteriətaɪp]　美 [ˈstɛriəˌtaɪp, ˈstɪr-]　
stimulus	刺激物; 刺激因素; 激法物	英 [ˈstɪmjələs]　美 [ˈstɪmjələs]　
stitch	（缝纫或编织中的）一针; 缝法; 衣服; （缝合伤口的）缝线	英 [stɪtʃ]　美 [stɪtʃ]　
straightforward	直截了当的; 坦率的; 明确的	英 [ˌstreɪtˈfɔ:wəd]　美 [ˌstreɪtˈfɔ:rwərd]　
stray	走失; 偏离正题; 走入歧途; （已婚者或有固定关系者）有外遇	英 [streɪ]　美 [stre]　
streamline	把…做成流线型; 使现代化; 组织; 使简单化	英 [ˈstri:mlaɪn]　美 [ˈstrimˌlaɪn]　
stride	步幅; 大步，阔步; 进展; 一跨（的宽度）	英 [straɪd]　美 [straɪd]　
subjective	主观的; 个人的; 内省的	英 [səbˈdʒektɪv]　美 [səbˈdʒɛktɪv]　
submarine	潜艇; 海底生物	英 [ˌsʌbməˈri:n]　美 [ˈsʌbməˌrin, ˌsʌbməˈrin]　
subordinate	下级的; 级别或职位较低的; 次要的; 附属的	英 [səˈbɔ:dɪnət]　美 [səˈbɔ:rdɪnət]　
stern	严肃的; 严厉的，严峻的; 坚定的，不动摇的	英 [stɜ:n]　美 [stɜ:rn]　
subtle	微妙的; 巧妙的; 敏感的; 狡猾的	英 [ˈsʌtl]　美 [ˈsʌtl]　
sue	起诉; 控告，控诉，和…打官司; 请求; 提起（诉讼）要求判决	英 [su:]　美 [su]　
suffice	足够; 有能力	英 [səˈfaɪs]　美 [səˈfaɪs]　
suite	[计]（软件的）套件; （房间，器具等）一套，一副; [乐]组曲; 随从	英 [swi:t]　美 [swit]　
sulphur	硫磺; 硫磺色，黄绿色; [动]粉蝶科蝶	英 ['sʌlfə(r)]　美 [ˈsʌlfɚ]　
supplementary	增补的，追加的; supplementary	英 [ˌsʌplɪˈmentri]　美 [ˌsʌplɪˈmentri]　
surge	汹涌; 大浪，波涛	英 [sɜ:dʒ]　美 [sɜ:rdʒ]　
susceptible	易受影响的; 易受感染的; 善感的; 可以接受或允许的	英 [səˈseptəbl]　美 [səˈsɛptəbəl]　
suspicious	可疑的; 猜疑的，怀疑的; 多疑的，不信任的; 多心	英 [səˈspɪʃəs]　美 [səˈspɪʃəs]　
swamp	湿地; 沼泽（地）	英 [swɒmp]　美 [swɑ:mp]　
symmetry	对称; 对称美; 整齐，匀称	英 [ˈsɪmətri]　美 [ˈsɪmɪtri]　
syndrome	综合征; 综合症状; 典型表现	英 [ˈsɪndrəʊm]　美 [ˈsɪndroʊm]　
tack	航向; [航]食物; 劣质材料，赝品; 方针，方法	英 [tæk]　美 [tæk]　
tan	黄褐色，棕黄色; 鞣料; 马戏团; 晒黑的皮色	英 [tæn]　美 [tæn]　
tangle	纠缠，纠纷; 混乱，慌乱; 昏乱的状态; 争论	英 [ˈtæŋgl]　美 [ˈtæŋɡəl]　
tease	挑逗; 取笑，戏弄; 强要	英 [ti:z]　美 [tiz]　
telecommunications	电讯; [电]电通信; 电信，通讯; 电信学	英 [ˌtelikəˌmju:nɪˈkeɪʃnz]　美 [ˌtelikəˌmjuːnɪˈkeɪʃnz]　
tempt	吸引; 引诱，怂恿; 冒…的风险; 使感兴趣	英 [tempt]　美 [tɛmpt]　
tentative	试探性的; 尝试性的; 试验的; 不确定的	英 [ˈtentətɪv]　美 [ˈtɛntətɪv]　
terminate	结束; 使终结; 解雇; 到达终点站	英 [ˈtɜ:mɪneɪt]　美 [ˈtɜ:rmɪneɪt]　
terrific	了不起的; 极好的; 异乎寻常的; 很大的	英 [təˈrɪfɪk]　美 [təˈrɪfɪk]　
terrify	使恐怖，使惊吓; 恐吓，吓唬; 威胁	英 [ˈterɪfaɪ]　美 [ˈtɛrəˌfaɪ]　
testimony	（法庭上证人的）证词; 证明，证据; 表示，表明; 声明，宣言	英 [ˈtestɪməni]　美 [ˈtestɪmoʊni]　
thermal	热的，保热的; 温热的	英 [ˈθɜ:ml]　美 [ˈθɜ:rml]　
thrill	使激动; 使陶醉; 使颤动、战栗或振动	英 [θrɪl]　美 [θrɪl]　
tile	瓦片，瓷砖; 空心砖; 麻将牌	英 [taɪl]　美 [taɪl]　
tilt	使倾斜; （在马上）拿枪扎; 抨击，攻击	英 [tɪlt]　美 [tɪlt]　
timid	胆小的; 羞怯的; 怕人; 羞手羞脚	英 [ˈtɪmɪd]　美 [ˈtɪmɪd]　
token	象征; 记号; 代币	英 [ˈtəʊkən]　美 [ˈtoʊkən]　
tow	牵引; 拖，拉	英 [təʊ]　美 [toʊ]　
toxic	有毒的; 中毒的; 因中毒引起的	英 [ˈtɒksɪk]　美 [ˈtɑ:ksɪk]　
trademark	（注册）商标; （人的行为或衣着的）特征，标记	英 [ˈtreɪdmɑ:k]　美 [ˈtreɪdmɑ:rk]　
trait	特点，特性; 少许	英 [treɪt]　美 [tret]　
transaction	交易，业务，事务; 办理，处理; （一笔）交易，（一项）事务; （学会等的）会议记录，学报	英 [trænˈzækʃn]　美 [trænˈsækʃən, -ˈzæk-]　
transient	短暂的; 转瞬即逝的; 临时的	英 [ˈtrænziənt]　美 [ˈtrænziənt]　
trench	战壕; 沟，渠	英 [trentʃ]　美 [trɛntʃ]　
tribute	致敬; 贡品; 悼念; 体现	英 [ˈtrɪbju:t]　美 [ˈtrɪbjut]　
triple	三倍的，三方的，三部分的	英 [ˈtrɪpl]　美 [ˈtrɪpəl]　
trivial	琐碎的，无价值的; 平常的，平凡的; 不重要的; [生]种的	英 [ˈtrɪviəl]　美 [ˈtrɪviəl]　
tuck	吃，喝; 折叠（衣服的）褶; 包起，裹起; 挤进	英 [tʌk]　美 [tʌk]　
tug	用力拉，使劲拉; 使劲，挣扎; [航海]用拖船拖曳; 竞争	英 [tʌg]　美 [tʌɡ]　
tumble	跌倒，摔倒; 被绊倒; 倒塌; 翻来覆去，翻腾	英 [ˈtʌmbl]　美 [ˈtʌmbəl]　
turbulent	骚乱的，混乱的; 激流的，湍流的; 吵闹的; 强横的	英 [ˈtɜ:bjələnt]　美 [ˈtɜ:rbjələnt]　
ultraviolet	紫外线的; 紫外的; 产生紫外线的	英 [ˌʌltrəˈvaɪələt]　美 [ˌʌltrəˈvaɪəlɪt]　
underestimate	低估; 看轻; 对…估计不足; 把…的价值估计过低	英 [ˌʌndərˈestɪmeɪt]　美 [ˌʌndɚˈɛstəmet]　
undermine	逐渐削弱; 使逐步减少效力; 从根基处破坏; 挖…的墙脚	英 [ˌʌndəˈmaɪn]　美 [ˌʌndərˈmaɪn]　
unfold	展开，打开	英 [ʌnˈfəʊld]　美 [ʌnˈfoʊld]　
unify	统一; 使联合; 使相同; 使一致	英 [ˈju:nɪfaɪ]　美 [ˈjunəˌfaɪ]　
update	更新，使现代化; 校正，修正	英 [ˌʌpˈdeɪt]　美 [ʌpˈdet]　
upgrade	向上的斜坡	英 [ˌʌpˈgreɪd]　美 [ˈʌpˌɡred]　
uphold	支持; 维持; 赞成; 支撑	英 [ʌpˈhəʊld]　美 [ʌpˈhoʊld]　
vegetation	植物（总称），草木; [医]赘生物，增殖体; 无所作为的生活，单调的生活; [植]营养体生长，发育	英 [ˌvedʒəˈteɪʃn]　美 [ˌvɛdʒɪˈteʃən]　
veil	面纱; 掩饰; 覆盖物; 托词	英 [veɪl]　美 [vel]　
vein	静脉; [地]矿脉，岩脉; [植]叶脉; 气质，倾向	英 [veɪn]　美 [ven]　
velvet	天鹅绒; 丝绒; 立绒; 赢得的钱	英 [ˈvelvɪt]　美 [ˈvɛlvɪt]　
vent	排气孔; 通风孔; （感情等的）发泄，吐露; （鸟，虫，鱼的）肛门	英 [vent]　美 [vɛnt]　
verge	边，边缘; 界限; 范围; 起始点	英 [vɜ:dʒ]　美 [vɜ:rdʒ]　
verse	诗篇; 诗，韵文; 诗节，诗行; 圣经中的节	英 [vɜ:s]　美 [vɜ:rs]　
versus	对抗; （表示两队或双方对阵）对; （比较两种不同想法、选择等）与…相对	英 [ˈvɜ:səs]　美 [ˈvɜ:rsəs]　
visa	签证	英 [ˈvi:zə]　美 ['vi:zə]　
visualise	 想象; 设想; 使可见;  使具体化	英 ['vɪzjʊəlaɪz]　美 ['vɪʒʊrlˌaɪz]　
visualize	设想; 形成思维图像; 使可见	英 [ˈvɪʒuəlaɪz]　美 [ˈvɪʒuəˌlaɪz]　
void	无效的; 空的，空虚的，没人住的; （职位）空缺着的	英 [vɔɪd]　美 [vɔɪd]　
vulnerable	（地方）易受攻击的; 易受伤的; 易受批评的; [桥牌]已成局的	英 [ˈvʌlnərəbl]　美 [ˈvʌlnərəbəl]　
wallet	钱包，皮夹子	英 [ˈwɒlɪt]　美 [ˈwɑ:lɪt]　
warehouse	仓库，货栈; 批发商店; 福利库	英 [ˈweəhaʊs]　美 [ˈwerhaʊs]　
watt	[电]瓦特	英 [wɒt]　美 [wɑ:t]　
weary	疲倦的; 困乏的; 令人厌倦[生厌，发腻]的; 感到厌倦的	英 [ˈwɪəri]　美 [ˈwɪri]　
